     #######
     #     #
    ##.*$# #
    #  ..$ #
#####$# $###
# $   # .#  
# #* *  $#  
#@ .. #  #  
###   ####  
  #####     
Author: David Holland
Title: teapot3
